#PREDIOS
3
1 96 96 96  PREDIO
2 30 5 61   PREDIO
3 50 10 50  PREDIO

#OBJETO
30 60
5   5   5   5   5   5   5   5   5   5   5   5   5   5   5   5   5   5   5   5   5   5   5   5   5   5   5   5   5   5  5   5   5   5   5   5   5   5   5   5   5   5   5   5   5   5   5   5   5   5   5   5   5   5   5   5   5   5   5   5  
3   4   4   4   4   4   4   4   4   4   4   4   4   4   2   2   4   4   4   4   4   4   2   4   4   4   4   4   4   4  3   4   4   4   4   4   4   4   4   4   4   4   4   4   2   2   4   4   4   4   4   4   2   4   4   4   4   4   4   4
6   5   5   5   5   5   5   5   5   5   5   5   5   5   6   6   5   5   5   5   5   5   6   5   5   5   5   5   5   5  6   5   5   5   5   5   5   5   5   5   5   5   5   5   6   6   5   5   5   5   5   5   6   5   5   5   5   5   5   5
6   5   5   5   5   5   5   5   5   5   5   5   5   5   6   6   5   5   5   5   5   5   6   5   5   5   5   5   5   5  6   5   5   5   5   5   5   5   5   5   5   5   5   5   6   6   5   5   5   5   5   5   6   5   5   5   5   5   5   5
6   5   5   5   5   5   5   5   5   5   5   5   5   5   6   6   5   5   5   5   5   5   6   5   5   5   5   5   5   5  6   5   5   5   5   5   5   5   5   5   5   5   5   5   6   6   5   5   5   5   5   5   6   5   5   5   5   5   5   5
6   5   5   5   5   5   5   5   5   5   5   5   5   5   6   6   5   5   5   5   5   5   6   5   5   5   5   5   5   5  6   5   5   5   5   5   5   5   5   5   5   5   5   5   6   6   5   5   5   5   5   5   6   5   5   5   5   5   5   5
6   5   5   5   5   5   5   5   5   5   5   5   5   5   6   6   5   5   5   5   5   5   6   5   5   5   5   5   5   5  6   5   5   5   5   5   5   5   5   5   5   5   5   5   6   6   5   5   5   5   5   5   6   5   5   5   5   5   5   5
6   5   5   5   5   5   5   5   5   5   5   5   5   5   6   6   5   5   5   5   5   5   6   5   5   5   5   5   5   5  6   5   5   5   5   5   5   5   5   5   5   5   5   5   6   6   5   5   5   5   5   5   6   5   5   5   5   5   5   5
6   5   5   5   5   5   5   5   5   5   5   5   5   5   6   6   5   5   3   4   4   4   6   5   5   5   5   5   5   5  6   5   5   5   5   5   5   5   5   5   5   5   5   5   6   6   5   5   3   4   4   4   6   5   5   5   5   5   5   5
6   5   5   5   5   5   5   5   5   5   5   5   5   5   6   6   5   5   6   5   5   5   6   5   5   5   5   5   5   5  6   5   5   5   5   5   5   5   5   5   5   5   5   5   6   6   5   5   6   5   5   5   6   5   5   5   5   5   5   5
6   5   5   5   5   5   5   5   5   5   5   5   5   5   6   6   5   5   6   5   5   5   6   5   5   5   5   5   5   5  6   5   5   5   5   5   5   5   5   5   5   5   5   5   6   6   5   5   6   5   5   5   6   5   5   5   5   5   5   5
6   5   5   5   5   5   5   5   5   5   5   5   5   5   6   6   5   5   6   5   5   5   6   5   5   5   5   5   5   5  6   5   5   5   5   5   5   5   5   5   5   5   5   5   6   6   5   5   6   5   5   5   6   5   5   5   5   5   5   5
6   5   5   5   5   5   5   5   5   5   5   5   5   5   6   6   5   5   6   5   5   5   6   5   5   5   5   5   5   5  6   5   5   5   5   5   5   5   5   5   5   5   5   5   6   6   5   5   6   5   5   5   6   5   5   5   5   5   5   5
6   5   5   5   5   5   5   5   5   5   5   5   5   5   6   6   5   5   6   5   5   5   6   5   5   5   5   5   5   5  6   5   5   5   5   5   5   5   5   5   5   5   5   5   6   6   5   5   6   5   5   5   6   5   5   5   5   5   5   5
6   5   5   5   5   5   5   5   5   5   5   5   5   5   6   6   5   5   6   5   5   5   6   5   5   5   5   5   5   5  6   5   5   5   5   5   5   5   5   5   5   5   5   5   6   6   5   5   6   5   5   5   6   5   5   5   5   5   5   5
6   5   5   5   5   5   5   5   5   5   5   5   5   5   6   6   5   5   6   5   5   5   6   5   5   5   5   5   5   5  6   5   5   5   5   5   5   5   5   5   5   5   5   5   6   6   5   5   6   5   5   5   6   5   5   5   5   5   5   5
6   5   5   5   5   5   5   5   5   5   5   5   5   5   6   6   5   5   6   5   5   5   6   5   5   5   5   5   5   5  6   5   5   5   5   5   5   5   5   5   5   5   5   5   6   6   5   5   6   5   5   5   6   5   5   5   5   5   5   5
6   5   5   5   5   5   5   5   5   5   5   5   5   5   6   6   5   5   6   5   5   5   6   5   5   5   5   5   5   5  6   5   5   5   5   5   5   5   5   5   5   5   5   5   6   6   5   5   6   5   5   5   6   5   5   5   5   5   5   5
6   5   5   5   5   5   5   5   5   5   5   5   5   5   6   6   5   5   5   5   5   5   6   5   5   5   5   5   5   5  6   5   5   5   5   5   5   5   5   5   5   5   5   5   6   6   5   5   5   5   5   5   6   5   5   5   5   5   5   5
6   5   5   5   5   5   5   5   5   5   5   5   5   5   6   6   5   5   5   5   5   5   6   5   5   5   5   5   5   5  6   5   5   5   5   5   5   5   5   5   5   5   5   5   6   6   5   5   5   5   5   5   6   5   5   5   5   5   5   5
8   4   4   4   4   4   4   4   4   4   4   4   4   4   0   0   4   4   4   4   4   4   0   4   4   4   4   4   4   4  8   4   4   4   4   4   4   4   4   4   4   4   4   4   0   0   4   4   4   4   4   4   0   4   4   4   4   4   4   4
6   5   5   5   5   5   5   5   5   5   5   5   5   5   6   6   5   5   5   5   5   5   6   5   5   5   5   5   5   5  6   5   5   5   5   5   5   5   5   5   5   5   5   5   6   6   5   5   5   5   5   5   6   5   5   5   5   5   5   5
6   5   5   5   5   5   5   5   5   5   5   5   5   5   6   6   5   5   5   5   5   5   6   5   5   5   5   5   5   5  6   5   5   5   5   5   5   5   5   5   5   5   5   5   6   6   5   5   5   5   5   5   6   5   5   5   5   5   5   5
6   5   5   5   5   5   5   5   5   5   5   5   5   5   6   6   5   5   5   5   5   5   6   5   5   5   5   5   5   5  6   5   5   5   5   5   5   5   5   5   5   5   5   5   6   6   5   5   5   5   5   5   6   5   5   5   5   5   5   5
6   5   5   5   5   5   5   5   5   5   5   5   5   5   6   6   5   5   5   5   5   5   6   5   5   5   5   5   5   5  6   5   5   5   5   5   5   5   5   5   5   5   5   5   6   6   5   5   5   5   5   5   6   5   5   5   5   5   5   5
6   5   5   5   5   5   5   5   5   5   5   5   5   5   6   6   5   5   5   5   5   5   6   5   5   5   5   5   5   5  6   5   5   5   5   5   5   5   5   5   5   5   5   5   6   6   5   5   5   5   5   5   6   5   5   5   5   5   5   5
8   4   4   4   4   4   4   4   4   4   4   4   4   4   0   0   4   4   4   4   4   4   0   4   4   4   4   4   4   4  8   4   4   4   4   4   4   4   4   4   4   4   4   4   0   0   4   4   4   4   4   4   0   4   4   4   4   4   4   4
6   5   5   5   5   5   5   5   5   5   5   5   5   5   6   6   5   5   5   5   5   5   6   5   5   5   5   5   5   5  6   5   5   5   5   5   5   5   5   5   5   5   5   5   6   6   5   5   5   5   5   5   6   5   5   5   5   5   5   5
6   5   5   5   5   5   5   5   5   5   5   5   5   5   6   6   5   5   5   5   5   5   6   5   5   5   5   5   5   5  6   5   5   5   5   5   5   5   5   5   5   5   5   5   6   6   5   5   5   5   5   5   6   5   5   5   5   5   5   5
11  4   4   4   4   4   4   4   4   4   4   4   4   4   10  10  4   4   4   4   4   4   10  4   4   4   4   4   4   4  10  4   4   4   4   4   4   4   4   4   4   4   4   4   10  10  4   4   4   4   4   4   10  4   4   4   4   4   4   4